{
  "width": 30,
  "height": 20,
  "tileSize": 32,
  "layers": [
    {
      "data": [
        0,0,0,0,0,0,0,0,0,0,0,0,0,0,0,0,0,0,0,0,0,0,0,0,0,0,0,0,0,0,
        0,0,0,0,1,1,1,1,1,1,1,1,1,1,1,1,1,1,1,1,1,1,1,1,1,1,0,0,0,0,
        0,0,0,1,2,0,0,0,0,0,0,0,0,0,0,0,0,0,0,0,0,0,0,0,2,1,0,0,0,0,
        0,0,1,1,1,1,1,1,1,1,1,1,1,1,1,1,1,1,1,1,1,1,1,1,1,1,0,0,0,0,
        0,1,2,0,0,0,0,0,0,0,0,0,0,0,0,0,0,0,0,0,0,0,0,0,0,2,1,0,0,0,
        0,1,1,1,1,1,1,1,1,1,1,1,1,1,1,1,1,1,1,1,1,1,1,1,1,1,1,0,0,0,
        0,1,2,0,0,0,0,0,0,0,0,0,0,0,0,0,0,0,0,0,0,0,0,0,0,0,2,1,0,0,
        0,1,1,1,1,1,1,1,1,1,1,1,1,1,1,1,1,1,1,1,1,1,1,1,1,1,1,1,0,0,
        0,1,2,0,0,0,0,0,0,0,0,0,0,0,0,0,0,0,0,0,0,0,0,0,0,0,0,2,1,0,
        0,1,1,1,1,1,1,1,1,1,1,1,1,1,1,1,1,1,1,1,1,1,1,1,1,1,1,1,1,0,
        0,1,2,0,0,0,0,0,0,0,0,0,0,0,0,0,0,0,0,0,0,0,0,0,0,0,0,0,2,1,
        0,1,1,1,1,1,1,1,1,1,1,1,1,1,1,1,1,1,1,1,1,1,1,1,1,1,1,1,1,1,
        0,1,2,0,0,0,0,0,0,0,0,0,0,0,0,0,0,0,0,0,0,0,0,0,0,0,0,0,0,2,
        0,1,1,1,1,1,1,1,1,1,1,1,1,1,1,1,1,1,1,1,1,1,1,1,1,1,1,1,1,1,
        0,1,2,0,0,0,0,0,0,0,0,0,0,0,0,0,0,0,0,0,0,0,0,0,0,0,0,0,0,2,
        0,1,1,1,1,1,1,1,1,1,1,1,1,1,1,1,1,1,1,1,1,1,1,1,1,1,1,1,1,1,
        0,1,2,0,0,0,0,0,0,0,0,0,0,0,0,0,0,0,0,0,0,0,0,0,0,0,0,0,0,2,
        0,1,1,1,1,1,1,1,1,1,1,1,1,1,1,1,1,1,1,1,1,1,1,1,1,1,1,1,1,1,
        0,0,0,0,1,1,1,1,1,1,1,1,1,1,1,1,1,1,1,1,1,1,1,1,1,1,0,0,0,0,
        0,0,0,0,0,0,0,0,0,0,0,0,0,0,0,0,0,0,0,0,0,0,0,0,0,0,0,0,0,0
      ],
      "name": "floor"
    }
  ],
  "boothPositions": {
    "A": {"x": 64, "y": 544}, "B": {"x": 64, "y": 64}, "C": {"x": 64, "y": 128},
    "D": {"x": 64, "y": 192}, "E": {"x": 64, "y": 256}, "F": {"x": 64, "y": 320},
    "G": {"x": 64, "y": 384}, "H": {"x": 64, "y": 448}, "I": {"x": 384, "y": 64},
    "J": {"x": 384, "y": 128}, "K": {"x": 512, "y": 448}, "L": {"x": 576, "y": 64},
    "M": {"x": 704, "y": 64}, "N": {"x": 832, "y": 64}, "O": {"x": 576, "y": 128},
    "P": {"x": 704, "y": 128}, "Q": {"x": 576, "y": 192}, "R": {"x": 704, "y": 192},
    "S": {"x": 832, "y": 192}, "T": {"x": 832, "y": 448}, "U": {"x": 704, "y": 448},
    "V": {"x": 384, "y": 256}, "W": {"x": 192, "y": 448}, "X": {"x": 448, "y": 384},
    "Y": {"x": 256, "y": 448}, "Z": {"x": 832, "y": 64}
  },
  "startPosition": {"x": 480, "y": 576},
  "exitPosition": {"x": 880, "y": 576}
}